7 7
X X X X X X X
X E E E E E X
X E E B E E X
X X X E B P X
X T T E E E X
X T T B E B X
X X X X X X X