22 11
E E E E X X X X X E E E E E E E E E E E E E
E E E E X E E E X E E E E E E E E E E E E E
E E E E X B E E X E E E E E E E E E E E E E
E E X X X E E B X X X E E E E E E E E E E E
E E X E E B E E B E X E E E E E E E E E E E
X X X E X E X X X E X E E E E E X X X X X X
X E E E X E X X X E X X X X X X X E E T T X
X E B E E B E E E E E E E E E E E E E T T X
X X X X X E X X X X E X P X X X X E E T T X
E E E E X E E E E E E X X X E E X X X X X X
E E E E X X X X X X X X E E E E E E E E E E