7 7
X X X X X X X
X E E E E E X
X X X B E E X
X E E E B P X
X T T E E E X
X T T B E E X
X X X X X X X