8 9
E E X X X X X E
X X X E E E X E
X T P B E E X E
X X X E B T X E
X T X X B E X E
X E X E T E X X
X B E b B B T X
X E E E T E E X
X X X X X X X X